00000000h000
00000000H000
00000000H000
00001111H000
001111111100
000011110000
000000000000
000000000000
000000000000