000000h00000
000000H00000
000000H00000
000000H11111
000000H00000
000000H00000
111111H00000
000000H00000
000000H00000