000000000000
000000111100
000h11100000
000H00000100
000H00001010
000111V00100
000000110000
000000000000
000000000000