000000000000
000000000000
000000000000
000000000000
000001100000
000011110000
110000000011
111000000V11
111100001111