000000000000
000000011000
000011000000
0110000101O1
111110011111
000000000001
000001100000
000000000000
111111111111