001100110000
000000000000
000001000000
000010100000
0001000V0000
00h000001000
00H000000100
00H000000000
111111111111