000000000H00
001000000H00
000100000H00
0000h0000H00
0000H0000H00
00001h000H00
00010H000H00
00100H000H00
111111001111