0H00000000H0
0h11111111h0
0H00000000H0
0H00000000H0
0H00000000H0
0H00000000H0
0H00000000H0
0H00000000H0
000000000000