111111111111
110000100011
110010000011
100001h00001
100000H00001
100000H00001
100000H00101
110000H01111
111000H01111