111111111111
000000000000
0000000H0000
0000011h0000
0000000H0000
0000000H0000
000011111000
000000000000
000000000000