111111111111
000000000000
000000000000
000001000000
000010100000
0000V1V00000
000000000000
000000000000
000000000000