111111111111
000000000000
0000000H0000
0000011h0000
111O110H0000
111111101OO1
000000101111
000000000000
000000000000