111111100000
000000000000
000000000000
011000111110
000001110000
000000000000
111110011111
000000000000
000001100000