111111111111
110000000011
100000000001
000000000000
000000000000
000000000000
000000000000
000001110000
001111111100