11111112
21111113
31111112
21111113
31111112
21111113