0000000000V0
0000000V00V0
0V00000V00V0
0V00000V0000
0V00V00V0000
0V00V0000000
0000V0000000
000000000000
111111111111