000000000000
110000000000
000000000000
000000010011
000011000000
000100000011
010000000000
111000000000
111O11111111