001100110000
000000000000
00000O000000
0000V1V00000
00HV000V0000
00h00000V000
00H000000V00
00H000000000
111111111111