000000000H00
00V000000H00
000VH0000H00
0000h0000H00
0000HH000H00
00001h000H00
000V0H000H00
00V00H000H00
OOOO1O00OOO1