111111111111
111111111111
110010000011
100001000000
100000H00000
100000H00000
100000H00100
110000H01111
111111111111