111111111111
110000100011
110010000011
000001000001
000000H00001
000000H00001
000000H00101
110000H01111
111111111111