111111111111
100000100001
100000100101
100100100101
0h0100100100
000100100100
00h100100100
100100000101
111111111111