111111111111
000000000000
000001100000
000000000000
OOOOOOOOOOOO
000000000000
000000000000
OOOOOOOOOOOO
111111111111