111111111111
0000000000H0
0000000001h0
0000000010H0
0000000100H0
000001O100H0
0000110000H0
0001100000H0
111111111111