111111111111
000000000000
000000000000
000000000000
000000000000
000000000000
000000000000
000000000000
11O110011O11