111111111111
000000000000
000000000000
000000000000
000000000000
000001000000
000010100000
000O111O0000
111111111111