111111H11111
000000h00000
000000H00000
000000H00000
000000H00000
000000H00000
000001H00000
000010010000
111111111111