111111111111
000000000000
V00000000000
V0000O1O0000
00000000000V
00000000000V
V000OO1OO000
V00000000000
00000000000V