111111111111
V0000000000V
000000000000
000001000000
V0001010000V
V000V1V0000V
000000000000
000000000000
V0000000000V