111111111111
00000000000V
0000000H0000
0000011h000V
OOOO110H0000
OOO111101OO0
00000010111V
000000000000
00000000000V