11111110000V
00000000000V
000000000000
OOO000111110
000001110000
000000000000
OOOOO0011110
000000000000
00000110000V