111111111111
1V000000001V
VV000000000V
000000000000
000000000000
100000000001
100000000001
00000111000V
00111111110V